border_size=1
usage=map

Aa          , Aa          , Aa          , Aa          , Aa          , Aa          , Gg          , Gg          , Gg          , Gg          , Rr          , Gg          , Gg          , Gg          , Gg          , Aa          , Aa          , Ai          , Ai          , Aa          , Aa          , Aa          , Aa          , Aa          , Aa^Fpa      , Aa^Fpa      , Aa^Fpa      , Aa^Fpa      , Aa^Fpa      , Ms          , Ms          , Ms          , Ms          , Ms          , Ms          , Ha          , Aa^Fpa      , Aa^Fpa      , Aa^Fpa      , Aa^Fpa      , Aa^Fpa      , Aa^Fpa      , Aa^Fpa      , Aa^Fpa      , Aa^Fpa      , Aa^Fpa      , Aa^Fpa      , Aa^Fpa      , Aa^Fpa      , Aa^Fpa      , Aa^Fpa      , Aa^Fpa      
Aa          , Aa          , Aa          , Aa          , Re^Gvs      , Gg          , Gg          , Gg          , Rr          , Rr          , Gg          , Gg          , Gg          , Gg          , Gg          , Gg          , Gg          , Aa          , Ai          , Aa          , Aa          , Aa          , Aa          , Aa          , Ha          , Aa^Fpa      , Aa^Fpa      , Aa^Fpa      , Aa^Fpa      , Aa^Fpa      , Ha          , Ms          , Ms          , Ms          , Ha          , Ha          , Aa^Fpa      , Aa^Fpa      , Aa^Fpa      , Aa^Fpa      , Aa^Fpa      , Aa^Fpa      , Aa^Fpa      , Aa^Fpa      , Aa^Fpa      , Aa^Fpa      , Aa^Fpa      , Aa^Fpa      , Aa^Fpa      , Aa^Fpa      , Aa^Fpa      , Aa^Fpa      
Aa          , Aa          , Re^Gvs      , Re^Gvs      , Re^Gvs      , Re^Gvs      , Rr          , Rr          , Gg          , Gg          , Gg          , Gg          , Gg          , Gg          , Gg          , Gg          , Gg          , Aa          , Ai          , Aa          , Aa          , Aa          , Aa          , Aa          , Ha          , Aa^Fpa      , Aa          , Aa^Fpa      , Aa^Fpa      , Aa^Fpa      , Ha          , Ms^Vhha     , Ms          , Ms          , Ms          , Ha          , Ha          , Aa^Fpa      , Aa          , Aa^Fpa      , Aa          , Aa^Fpa      , Aa^Fpa      , Aa^Fpa      , Ms          , Aa^Fpa      , Aa^Fpa      , Aa^Fpa      , Aa^Fpa      , Aa^Fpa      , Aa^Fpa      , Aa^Fpa      
Gg          , Gg          , Gg          , Re^Gvs      , Gg^Ve       , Gg          , Rr          , Aa^Fdw      , Gg          , Gg          , Re^Gvs      , Re^Gvs      , Re^Gvs      , Gg          , Gg          , Gg          , Gg          , Aa          , Ai          , Ai          , Ai          , Aa          , Gg          , Gg          , Gg          , Aa          , Aa          , Aa          , Aa^Fpa      , Aa^Fpa      , Aa^Fpa      , Ms          , Ms          , Ms          , Ms          , Ms          , Ha          , Aa          , Aa          , Aa          , Aa          , Aa          , Ha          , Ms          , Ms          , Ms          , Ms          , Ha          , Ha          , Ha          , Ha          , Ha          
Gg          , Gg^Efm      , Gg          , Gg          , Rr          , Rr          , Gg          , Gg          , Gg          , Re^Gvs      , Re^Gvs      , Re^Gvs      , Gg^Ve       , Gg          , Gg          , Aa^Fdw      , Gg          , Aa          , Aa          , Ai          , Aa          , Aa          , Gg          , Gg          , Gg          , Gg          , Gg          , Aa          , Aa^Fpa      , Aa^Fpa      , Aa^Fpa      , Ms          , Aa^Fpa      , Ms          , Ha          , Ha          , Aa          , Aa          , Aa          , Aa          , Aa          , Aa          , Aa          , Ha          , Ha          , Ms          , Ms          , Ms          , Ms          , Ms          , Ha          , Ha          
Gg          , Gg          , Gg          , Aa^Fdw      , Rr          , Gg          , Gg          , Gg^Efm      , Gg          , Gg          , Gg          , Gg          , Gg          , Gg          , Aa          , Aa          , Aa          , Gg          , Gg          , Aa          , Gg          , Gg          , Aa          , Gg          , Gg          , Gg          , Gg          , Gg          , Gs^Fp       , Aa^Fpa      , Gs^Fp       , Hh          , Mm          , Mm          , Mm          , Hh          , Hh          , Aa          , Aa          , Aa          , Aa          , Aa          , Aa          , Aa          , Ha          , Ha          , Ms^Vhha     , Ms          , Ms          , Ms          , Aa^Fpa      , Aa^Fpa      
Gg          , Gg          , Gg          , Gg          , Rr          , Gg          , Gg          , Gg          , Gg          , Gg          , Aa          , Gg          , Gg^Efm      , Gg          , Aa          , Aa          , Gg          , Gg          , Gg          , Gg          , Gg          , Gg^Efm      , Gg          , Aa          , Gg          , Gg          , Aa          , Aa          , Gs^Fp       , Rd          , Rd          , Gs^Fp       , Gs^Fp       , Mm          , Mm          , Mm          , Ms          , Aa          , Gg^Efm      , Aa          , Aa          , Aa          , Aa          , Aa          , Mm          , Ms          , Ms          , Ha          , Aa^Fpa      , Aa^Fpa      , Aa          , Aa^Fpa      
Aa          , Gg          , Gg          , Gg          , Rr          , Gg          , Re^Gvs      , Gg          , Gg          , Gg          , Gg          , Gg          , Gg          , Gg          , Aa          , Gg          , Gg          , Gg          , Gg          , Gg          , Gg          , Gg          , Gg          , Gg          , Gg          , Gg          , Gs^Fp       , Gs^Fp       , Hh^Fp       , Gs^Fp       , Gs^Fp       , Gs^Fp       , Hh          , Gs^Fp       , Hh^Fp       , Mm          , Mm          , Aa^Fpa      , Ch          , Rd          , Ch          , Aa          , Mm          , Mm          , Mm          , Mm          , Aa^Fpa      , Aa^Fpa      , Aa          , Aa          , Aa          , Aa^Fpa      
Aa          , Gg          , Gg          , Gg          , Rr          , Gg^Ve       , Re^Gvs      , Aa          , Gg          , Gg          , Gg          , Gg          , Aa^Fdw      , Aa          , Ha          , Hh          , Aa          , Aa          , Gg          , Hh          , Gg          , Gg          , Gg          , Gg          , Gg          , Gg          , Gs^Fp       , Gs^Fp       , Hh^Fp       , Mm^Vhh      , Mm          , Hh          , Mm          , Mm          , Mm          , Hh^Fp       , Hh          , Mm          , Mm          , Rd          , Mm          , Mm          , Mm          , Mm          , Mm          , Aa^Fpa      , Rd          , Aa^Fpa      , Ha          , Aa          , Aa^Fpa      , Ha          
Aa          , Aa          , Gg          , Gg          , Rr          , Gg          , Gg          , Gg          , Gg          , Gg          , Re^Gvs      , Gg          , Gg          , Aa          , Ha          , Hh          , Aa          , Gg          , Hh          , Hh          , Gg          , Gg          , Aa          , Gg          , Gg          , Gg          , Gs^Fp       , Hh^Fp       , Mm          , Mm          , Mm          , Mm          , Cud         , 1 Kud       , Cud         , Mm          , Mm          , Hh          , Rd          , Rd          , Mm          , Mm          , Mm          , Mm          , Mm          , Aa^Fpa      , Hh          , Ha          , Aa^Fpa      , Ha          , Aa^Fpa      , Ha          
Aa          , Aa          , Gg          , Gg          , Rr          , Gg          , Gg          , Gg          , Aa          , Aa          , Aa          , Re^Gvs      , Gg^Ve       , Gg          , Hh          , Ha          , Gg          , Gg          , Hh          , Gg          , Gg          , Gg          , Gg          , Gg          , Gg          , Gg          , Hh          , Hh          , Mm          , Mm          , Ha          , Hh          , Cud         , Cud         , Cud         , Cud         , Gg          , Gg^Vh       , Rd          , Mm          , Rr          , Rr          , Hh^Fp       , Mm          , Rd          , Aa          , Mm          , Hh          , Ha          , Ha          , Aa          , Aa^Fpa      
Aa          , Aa          , Gg          , Gg^Ve       , Rr          , Gg          , Gg          , Aa          , Re^Gvs      , Re^Gvs      , Gg          , Gg          , Gg          , Gg          , Hh          , Gg          , Gg          , Aa          , Ha          , Hh          , Aa          , Gg          , Gg          , Gg          , Gs^Fp       , Hh          , Mm          , Mm          , Mm          , Mm          , Mm          , Hh          , Gs^Fp       , Cud         , Gg^Vh       , Cud         , Re^Gvs      , Wwf         , Rr          , Rr          , Mm          , Rr          , Rr          , Gs^Fp       , Mm          , Mm          , Mm          , Mm          , Mm          , Aa^Fpa      , Aa^Fpa      , Aa^Fpa      
Aa          , Aa          , Gg          , Gg          , Rr          , Ce          , Ce          , Gg^Ve       , Gg          , Gg          , Gg          , Gg          , Gg          , Gg          , Hh          , Gg          , Gg          , Aa          , Ha          , Aa^Fdw      , Aa          , Gg          , Gg          , Gs^Fp       , Gs^Fp       , Hh          , Mm          , Mm          , Ms          , Mm          , Mm          , Mm          , Gs^Fp       , Gg          , Re^Gvs      , Re^Gvs      , Wwf         , Wwf         , Rr          , Gg^Vh       , Gs^Fp       , Mm          , Mm          , Rr          , Rr          , Mm          , Rr          , Mm^Vhh      , Mm          , Mm          , Mm          , Aa^Fpa      
Aa          , Gg          , Gg          , Gg          , Rr          , Ce          , Ce          , Ce          , Gg          , Gg          , Gg          , Aa          , Gg          , Gg          , Hh          , Gg          , Gg          , Aa^Fdw      , Ha          , Ha          , Gg          , Gg          , Aa          , Gg          , Gg          , Hh          , Hh^Fp       , Mm          , Ms          , Ms          , Mm          , Gs^Fp       , Gs^Fp       , Re^Gvs      , Gg          , Gg^Vh       , Rr          , Ww^Bw/      , Ww          , Rr          , Rr          , Gs^Fp       , Gg^Vh       , Hh          , Mm          , Rr          , Mm          , Rr          , Rr          , Ch          , Rr          , Mm          
Gg          , Gg          , Gg          , Gg^Ve       , Rr          , 3 Ke        , Gg^Ve       , Gg          , Gg          , Gg          , Gg          , Gg          , Gg          , Gg          , Hh          , Gg          , Gg          , Gg          , Hh          , Gg          , Gg          , Gg          , Aa          , Gg          , Gg          , Gs^Fp       , Mm          , Mm          , Mm          , Mm          , Hh          , Mm          , Chr         , Gs^Fp       , Rr          , Rr          , Wwf         , Ww          , Ww          , Ww          , Wwf         , Rr          , Rr          , Mm          , Mm          , Rr          , Dd^Dr       , Mm          , Mm          , Rr          , Rr          , Rr          
Rr          , Rr          , Rr          , Rr          , Rr          , Rr          , Rr          , Rr          , Rr          , Rr          , Rr          , Rr          , Rr          , Rr          , Rr          , Rr          , Rr          , Rr          , Rr          , Rr          , Rr          , Gg          , Gg          , Gg          , Gg          , Gs^Fp       , Hh^Fp       , Mm          , Hh^Vhh      , Gs^Fp       , Gg          , Hh          , Rr          , Rr          , Chr         , Gg          , Gg          , Gg^Vh       , Re^Gvs      , Re^Gvs      , Re^Gvs      , Gg^Vh       , Rr          , Mm          , Dd^Dr       , Dd^Dr       , Dd^Dc       , Dd^Dr       , Mm          , Ch          , Mm          , Mm          
Gg          , Gg          , Gg^Ve       , Rr          , Rr          , 2 Ke        , Ce          , Ce          , Ce          , Gg^Ve       , Gg          , Gg          , Gg          , Gg          , Gg          , Gg          , Gg          , Gg          , Gg          , Gg          , Gg          , Rr          , Rr          , Gg          , Gg          , Mm          , Mm          , Hh^Fp       , Gs^Fp       , Gg          , Rr          , Rr          , Hh          , Hh          , Mm          , Gg          , Gg^Wm       , Re^Gvs      , Re^Gvs      , Re^Gvs      , Re^Gvs      , Re^Gvs      , Rr          , Mm          , Mm          , Dd^Dr       , Dd^Dr       , Dd^Dr       , Mm          , Mm          , Mm          , Mm          
Gg          , Gg          , Ce          , 4 Ke        , Ce          , Rr          , Ce          , Ce          , Gg          , Gg          , Gg          , Gg          , Gg          , Gg          , Gg          , Gg^Ve       , Gg          , Gg          , Gg          , Aa          , Gg          , Gg          , Gg          , Rr          , Rr          , Hh          , Rr          , Chr         , Rr          , Rr          , Rd          , Gs^Fp       , Gg^Vh       , Hh          , Rd          , Rd          , Gs^Fp       , Re^Gvs      , Re^Gvs      , Re^Gvs      , Re^Gvs      , Re^Gvs      , Rr          , Hh          , Mm          , Mm          , Hh^Fp       , Hh          , Mm          , Ms          , Mm          , Mm          
Gg          , Gg          , Gg          , Ce          , Ce          , Rr          , Gg^Ve       , Gg          , Gg          , Gg          , Aa          , Gg          , Gg          , Gg          , Hh          , Gg          , Gg          , Gg          , Gg          , Gg          , Aa          , Gg          , Gg          , Gg          , Gg          , Rr          , Gg          , Rr          , Mm          , Gs^Fp       , Aa^Fpa      , Rd          , Rd          , Rd          , Gs^Fp       , Gs^Fp       , Gs^Fp       , Rd          , Gs^Fp       , Re^Gvs      , Re^Gvs      , Re^Gvs      , Rr          , Gg^Vh       , Gs^Fp       , Mm          , Gs^Fp       , Gs^Fp       , Gs^Fp       , Mm          , Ms          , Ms          
Aa          , Gg          , Gg          , Ce          , Gg^Ve       , Rr          , Gg          , Gg          , Gg          , Aa          , Gg          , Gg          , Gg          , Gg          , Aa^Fdw      , Aa^Fdw      , Gg          , Gg          , Gg          , Gg          , Gg          , Gg          , Gg          , Gg          , Gg          , Gg          , Gg          , Chr         , Mm          , Ms          , Mm          , Gs^Fp       , Rd          , Mm          , Ms          , Gs^Fp       , Gs^Fp       , Rd          , Rd          , Gs^Fp       , Hh          , Gg^Vh       , Gs^Fp       , Rr          , Mm          , Gs^Fp       , Gs^Fp       , Mm          , Mm          , Aa^Fpa      , Ms          , Ms          
Aa          , Gg          , Gg          , Gg          , Gg          , Rr          , Gg          , Gg^Efm      , Gg          , Aa          , Gg          , Gg          , Aa^Fdw      , Gg          , Aa          , Ha          , Gg          , Gg          , Gg          , Gg          , Hh          , Hh          , Hh          , Gg          , Gs^Fp       , Gg          , Rd          , Mm          , Rd          , Aa^Fpa      , Mm          , Rd          , Mm          , Hh          , Mm          , Mm          , Mm          , Mm          , Mm          , Rd          , Gs^Fp       , Mm          , Mm          , Rr          , Rr          , Mm          , Gs^Fp       , Gs^Fp       , Mm          , Mm          , Mm          , Ms          
Aa          , Gg          , Gg          , Gg          , Gg          , Rr          , Rr          , Gg          , Aa          , Gg          , Gg          , Gg          , Gg^Ve       , Gg          , Aa          , Ha          , Gg          , Gg          , Gs^Fp       , Gs^Fp       , Gs^Fp       , Hh^Fp       , Hh^Fp       , Hh          , Mm          , Gs^Fp       , Mm          , Rd          , Gs^Fp       , Rd          , Rd          , Rd          , Rd          , Rd          , Rd          , Mm          , Mm          , Mm          , Rd          , Rd          , Mm          , Hh          , Ms          , Mm          , Chr         , Rr          , Chr         , Mm          , Mm          , Mm          , Mm          , Mm          
Aa          , Aa          , Gg          , Gg          , Aa          , Gg          , Gg          , Rr          , Rr          , Gg          , Aa          , Gg          , Gg          , Gg          , Hh          , Hh          , Gg          , Gg          , Gs^Fp       , Mm          , Mm          , Hh^Fp       , Mm^Vhh      , Mm          , Mm^Xm       , Mm          , Mm          , Mm          , Mm          , Gs^Fp       , Hh          , Gs^Fp       , Mm^Vhh      , Gs^Fp       , Rd          , Gs^Fp       , Rd          , Gs^Fp       , Rd          , Mm          , Mm          , Ms          , Ms          , Mm          , Mm          , Rr          , Gs^Fp       , Mm          , Mm          , Mm^Vhh      , Mm          , Mm          
Aa          , Gg          , Gg          , Gg          , Aa          , Aa          , Re^Gvs      , Gg          , Gg          , Rr          , Rr          , Gg          , Gg          , Gg          , Gg          , Gg          , Gg          , Gg          , Gs^Fp       , Mm          , Mm          , Mm          , Mm^Xm       , Mm          , Mm^Xm       , Mm^Xm       , Mm^Xm       , Mm^Xm       , Mm^Xm       , Mm^Xm       , Mm^Xm       , Mm^Xm       , Mm^Xm       , Hh          , Gs^Fp       , Rd          , Gs^Fp       , Rd          , Rd          , Mm          , Mm          , Mm          , Mm          , Mm          , Gs^Fp       , Rr          , Rr          , Gs^Fp       , Gs^Fp       , Gs^Fp       , Gs^Fp       , Aa^Fpa      
Gg          , Gg          , Gg          , Gg          , Re^Gvs      , Re^Gvs      , Re^Gvs      , Re^Gvs      , Re^Gvs      , Gg          , Gg          , Rr          , Rr          , Gg          , Gg          , Gg          , Gg          , Gs^Fp       , Mm          , Mm          , Mm          , Mm          , Mm          , Mm^Xm       , Mm^Xm       , Mm^Xm       , Mm^Xm       , Mm^Xm       , Mm^Xm       , Mm^Xm       , Mm^Xm       , Mm^Xm       , Mm^Xm       , Mm^Xm       , Mm^Xm       , Gs^Fp       , Hh          , Hh          , Gg^Efm      , Rd          , Hh          , Mm^Vhh      , Gs^Fp       , Gs^Fp       , Gs^Fp       , Gs^Fp       , Gg          , Rr          , Rr          , Gg          , Gg          , Gg          
Hh^Fp       , Gg          , Gg          , Re^Gvs      , Hh          , Re^Gvs      , Hh          , Hh          , Hh          , Gg^Ve       , Hh          , Gg          , Gg          , Rr          , Rr          , Gg          , Hh          , Hh          , Hh          , Hh          , Hh          , Mm          , Mm          , Mm          , Mm          , Mm^Xm       , Mm          , Mm          , Mm          , Mm^Xm       , Mm^Xm       , Mm^Xm       , Mm^Xm       , Mm^Xm       , Mm^Xm       , Mm          , Mm          , Hh          , Gs^Fp       , Rd          , Gs^Fp       , Gs^Fp       , Gs^Fp       , Gs^Fp       , Gg          , Gg          , Gg          , Gg          , Gg          , Rr          , Rr          , Gg          
Hh          , Hh^Fp       , Hh          , Hh          , Hh^Fp       , Hh          , Hh^Fp       , Hh^Fp       , Gs^Fp       , Hh          , Gs^Fp       , Gs^Fp       , Aa          , Gg          , Gs^Fp       , Rr          , Rr          , Rr          , Rr          , Rr          , Rr          , Hh          , Hh          , Mm          , Mm          , Mm          , Mm^Vhh      , Mm          , Mm          , Mm          , Mm^Xm       , Mm^Xm       , Mm^Xm       , Mm^Xm       , Mm          , Mm^Xm       , Mm          , Mm          , Gs^Fp       , Rd          , Rd          , Gs^Fp       , Gs^Fp       , Gs^Fp       , Gg          , Gg          , Gg          , Gg^Ve       , Gg          , Gg          , Gg          , Rr          
Gs^Fp       , Hh          , Hh^Fp       , Hh^Fp       , Hh^Fp       , Hh^Fp       , Hh          , Hh          , Hh          , Gs^Fp       , Hh^Fp       , Gs^Fp       , Hh          , Hh          , Hh          , Hh          , Hh          , Hh          , Hh          , Hh          , Hh          , Rr          , Rr          , Hh          , Hh          , Mm          , Hh          , Mm          , Mm          , Mm          , Mm          , Mm          , Mm          , Mm^Xm       , Mm          , Mm^Xm       , Mm          , Gs^Fp       , Gs^Fp       , Gs^Fp       , Gs^Fp       , Gs^Fp       , Gs^Fp       , Gs^Fp       , Gg          , Gg          , Gg          , Gg          , Ce          , Ce          , Gg          , Gg          
Gs^Fp       , Hh^Fp       , Hh^Fp       , Hh^Fp       , Hh          , Hh          , Mm          , Mm          , Mm          , Hh          , Hh          , Hh^Fp       , Hh^Vhh      , Mm          , Mm          , Mm          , Mm          , Mm          , Mm          , Mm          , Mm          , Hh          , Hh          , Rr          , Rr          , Hh          , Hh          , Hh          , Hh          , Mm          , Mm          , Mm          , Mm          , Mm          , Mm          , Mm          , Mm          , Mm          , Mm^Vhh      , Gs^Fp       , Gs^Fp       , Gs^Fp       , Rd          , Rd          , Gs^Fp       , Gg          , Gg          , Gg          , Ce          , Ce          , Gg          , Gg          
Gs^Fp       , Gs^Fp       , Gs^Fp       , Gs^Fp       , Hh          , Mm          , Mm          , Mm          , Mm^Xm       , Mm          , Mm          , Hh          , Mm          , Mm          , Mm          , Mm          , Mm          , Mm          , Mm          , Mm          , Mm          , Mm          , Mm          , Hh          , Hh          , Rr          , Rr          , Hh          , Hh          , Mm          , Mm          , Mm          , Mm          , Mm          , Mm          , Mm          , Mm          , Mm          , Mm          , Gs^Fp       , Gs^Fp       , Gs^Fp       , Gs^Fp       , Gs^Fp       , Gs^Fp       , Gs^Fp       , Gg          , Gg          , Ce          , Ce          , Gg          , Gg          
Hh          , Hh          , Hh          , Hh          , Mm          , Mm^Vhh      , Mm          , Mm^Xm       , Mm^Xm       , Mm^Xm       , Gs^Fp       , Mm          , Mm          , Mm          , Mm          , Mm          , Mm          , Mm          , Mm          , Mm          , Mm          , Mm          , Mm          , Mm          , Hh          , Hh          , Hh          , Rr          , Rr          , Mm          , Mm          , Mm^Xm       , Mm^Xm       , Mm^Vhh      , Mm          , Mm          , Gs^Fp       , Gs^Fp       , Gs^Fp       , Gs^Fp       , Gs^Fp       , Gs^Fp       , Gs^Fp       , Gs^Fp       , Gs^Fp       , Gs^Fp       , Gs^Fp       , Gg          , Gg          , 5 Ke        , Gg          , Gg          
Mm          , Hh          , Mm          , Mm          , Mm          , Mm^Xm       , Mm^Xm       , Mm^Xm       , Mm^Xm       , Mm^Xm       , Mm^Xm       , Mm          , Mm          , Mm          , Mm          , Mm          , Mm          , Mm          , Mm          , Mm          , Mm          , Mm          , Mm          , Mm          , Hh          , Hh          , Hh          , Hh          , Rr          , Hh          , Hh          , Mm          , Mm^Xm       , Mm          , Mm          , Gs^Fp       , Gs^Fp       , Gs^Fp       , Gs^Fp       , Gs^Fp       , Gs^Fp       , Gs^Fp       , Gs^Fp       , Gs^Fp       , Gs^Fp       , Gs^Fp       , Gs^Fp       , Gg          , Gg          , Gg          , Gg          , Gg          
